11111111111111111111111111
1E000V000000V00C0000VC0001
1V100101001000001010010V01
1010V100101V1010V01V010001
1P000000VCV0C00000000000V1
11111111111111111111111111