111111111111111111
10000V000V00C10001
1011000V000V1001C1
1011111C0110001111
100000011CV010V1C1
10111101V000100001
1000100V00101V0101
111010100100100101
1P0010001C01E0V1C1
111111111111111111
